11111
100P1
10101
10001
10101
10101
1E1C1
11111
