11111111111111111111111111111111111111
100000011110000000001100000100000000C1
1000000C1110000001001100000100000E0001
100000001100000001C1100000010000000001
10000000010000000111000000010011111111
10000000000000000011000000010000000001
10000000000000000000000000000000000001
10000000000000C00000000000000000000001
10000000110000000000000C00000000000001
11000011111000001011111111110000001111
10C0000111000C001011011110110000001111
10000000110000001011110011110000001111
11100011111111001C1100000011000C001111
1111P111111111111111111111111100011111
11111111111111111111111111111111111111
