11111111
1C111011
1P0001C1
11100001
11111111
11111E11
11111111
