11111
100C1

10C01
1PE01
11111
